TILEMAP
48 26 							-- Size of tile map in tiles
8 8 							-- Tile size & block size
images/blocks.png 	-- Tilesheet
8 12 								-- Number of tiles in tilesheet
1 2 1 2 1 2 1 2 1 2 1 2 1 2 1 2 1 2 1 2 1 2 1 2 1 2 1 2 1 2 1 2 1 2 1 2 1 2 1 2 1 2 1 2 1 2 1 2 
1 0 0 0 0 0 0 0 0 0 0 0 0 0 0 0 0 0 0 0 0 0 0 0 0 0 0 0 0 0 0 0 0 0 0 0 0 0 0 0 0 0 0 0 0 0 0 1 
1 0 0 0 0 0 0 0 0 0 0 0 0 0 0 0 0 0 0 0 0 0 0 0 0 0 0 0 0 0 0 0 0 0 0 0 0 0 0 0 0 0 0 0 0 0 0 1 
1 0 0 0 0 0 0 0 0 0 0 0 0 0 0 0 0 0 0 0 0 0 0 0 0 0 0 0 0 0 0 0 0 0 0 0 0 0 0 0 0 0 0 0 0 0 0 1 
1 0 0 0 0 0 0 0 0 0 7 0 0 0 0 0 0 0 0 81 0 0 0 0 0 0 0 0 81 0 0 0 0 0 0 0 0 7 0 0 0 0 0 0 0 0 0 1 
1 0 0 0 0 0 0 0 0 0 23 0 0 0 0 0 0 0 0 82 0 0 0 0 0 0 0 0 82 0 0 0 0 0 0 0 0 23 0 0 0 0 0 0 0 0 0 1 
1 0 0 0 0 0 0 0 0 0 15 0 0 0 0 0 0 0 0 83 0 0 0 0 0 0 0 0 83 0 0 0 0 0 0 0 0 15 0 0 0 0 0 0 0 0 0 1 
1 0 0 0 0 0 0 0 0 0 15 0 0 0 0 0 0 0 0 84 0 0 0 0 0 0 0 0 84 0 0 0 0 0 0 0 0 15 0 0 0 0 0 0 0 0 0 1 
1 0 0 0 0 0 0 0 0 0 15 0 0 0 0 0 0 0 0 81 0 0 0 0 0 0 0 0 81 0 0 0 0 0 0 0 0 15 0 0 0 0 0 0 0 0 0 1 
1 0 0 0 0 0 0 0 0 0 15 0 0 0 0 0 0 0 0 82 0 0 0 0 0 0 0 0 82 0 0 0 0 0 0 0 0 15 0 0 0 0 0 0 0 0 0 1 
1 0 0 0 0 0 0 0 0 0 15 0 0 0 0 0 0 0 0 83 0 0 0 0 0 0 0 0 83 0 0 0 0 0 0 0 0 15 0 0 0 0 0 0 0 0 0 1 
1 0 0 0 0 0 0 0 0 0 15 0 0 0 0 0 0 0 0 84 0 0 0 0 0 0 0 0 84 0 0 0 0 0 0 0 0 15 0 0 0 0 0 0 0 0 0 1 
1 0 0 0 0 0 0 0 0 0 15 0 0 0 0 0 0 0 0 81 0 0 0 0 0 0 0 0 81 0 0 0 0 0 0 0 0 15 0 0 0 0 0 0 0 0 0 1 
1 0 0 0 0 0 0 0 0 0 15 0 0 0 0 0 0 0 0 82 0 0 0 0 0 0 0 0 82 0 0 0 0 0 0 0 0 15 0 0 0 0 0 0 0 0 0 1 
1 0 0 0 0 0 0 0 0 0 15 0 0 0 0 0 0 0 0 83 0 0 0 0 0 0 0 0 83 0 0 0 0 0 0 0 0 15 0 0 0 0 0 0 0 0 0 1 
1 0 0 0 0 0 0 0 0 0 15 0 0 0 0 0 0 0 0 84 0 0 0 0 0 0 0 0 84 0 0 0 0 0 0 0 0 15 0 0 0 0 0 0 0 0 0 1 
1 0 0 0 0 0 0 0 0 0 15 0 0 0 0 0 0 0 0 81 0 0 0 0 0 0 0 0 81 0 0 0 0 0 0 0 0 15 0 0 0 0 0 0 0 0 0 1 
1 0 0 0 0 0 0 0 0 0 15 0 0 0 0 0 0 0 0 82 0 0 0 0 0 0 0 0 82 0 0 0 0 0 0 0 0 15 0 0 0 0 0 0 0 0 0 1 
1 0 0 0 0 0 0 0 0 0 15 0 0 0 0 0 0 0 0 83 0 0 0 0 0 0 0 0 83 0 0 0 0 0 0 0 0 15 0 0 0 0 0 0 0 0 0 1 
1 0 0 0 0 0 0 0 0 0 31 0 0 0 0 0 0 0 0 84 0 0 0 0 0 0 0 0 84 0 0 0 0 0 0 0 0 31 0 0 0 0 0 0 0 0 0 1 
1 0 0 0 0 0 0 0 0 0 0 0 0 0 0 0 0 0 0 0 0 0 0 0 0 0 0 0 0 0 0 0 0 0 0 0 0 0 0 0 0 0 0 0 0 0 0 1 
1 0 0 0 0 0 0 0 0 0 0 0 0 0 0 0 0 0 0 0 0 0 0 0 0 0 0 0 0 0 0 0 0 0 0 0 0 0 0 0 0 0 0 0 0 0 0 1 
1 0 0 0 0 0 0 0 0 0 0 0 0 0 0 0 0 0 0 0 0 0 0 0 0 0 0 0 0 0 0 0 0 0 0 0 0 0 0 0 0 0 0 0 0 0 0 1 
1 0 0 0 0 0 0 0 0 0 0 0 0 0 0 0 0 0 0 0 0 0 0 0 0 0 0 0 0 0 0 0 0 0 0 0 0 0 0 0 0 0 0 0 0 0 0 1 
1 0 0 0 0 0 0 0 0 0 0 0 0 0 0 0 0 0 0 0 0 0 0 0 0 0 0 0 0 0 0 0 0 0 0 0 0 0 0 0 0 0 0 0 0 0 0 1 
1 2 1 2 1 2 1 2 1 2 1 2 1 2 1 2 1 2 1 2 1 2 1 2 1 2 1 2 1 2 1 2 1 2 1 2 1 2 1 2 1 2 1 2 1 2 1 2




